...############################
........................#.....#
#..##########..#..####..#..####
#...........#..#.....#........#
#..#..#..#######..####..#######
#..#..#..#........#...........#
##########..#..#..#..####..#..#
#..#........#..#..#..#.....#..#
#..#######..##########..####..#
#.................#..#.....#..#
#..################..#######..#
#........#..............#.....#
#..#..#..#..####..##########..#
#..#..#.....#..#..#........#..#
#..#..####..#..#######..#..#..#
#..#..#..#.....#.....#..#.....#
#..#..#..#######..#######..#..#
#..#........#..#........#..#..#
####..#..#..#..#..####..####..#
#.....#..#..#........#........#
############################..#
